XXXXXXXXXXXXXXXX
X     X        X
XX XXXXX  XXXX X
X  X         X X
X XX  XXXXXX X X
X X        X X X
X XP         X X
X X        X X X
X XXXXXXXX XXX X
X        X X X X
X  XXXX  X X X X
X     X  X   X X
XXXX  XXXXXX X X
X            X X
X  XXXXXXXXXXX X
X             FX
XXXXXXXXXXXXXXXX
