XXXXXXX1XXX1XXXX
33  F43        X
3  3333 333333 X
3 3     3    X X
3 3 33333333 X 1
3 3 5  5  5  X X
3 3 P        2 X
3 3 5  5  5  X X
3  3333333333X 1
33           X X
3 3333333333 X X
3   3      3 X X
333 3 333333 X 1
3            X X
3 333333333333 X
3              X
XXX1XXX1XXX1XXXX
