XXXXXXXXXXXXXXXX
X              X
X  XXXXX  XXX  X
X  X          XX
X  X  XXXXXX  X
X     X    X   X
X  P  X    X   X
X     X        X
XXXX  XXXX  XXXX
X        X     X
X  XXXX  X  X  X
X     X     X  X
X  X  XXXXX X  X
X  X        X  X
X  XXXXXXXXXX  X
X              X
XXXXXXXXXXXXXXXX
